NO ./path_to_the_north_texture.xpm
SO ./path_to_the_south_texture.xpm
WE ./path_to_the_west_texture.xpm
EA ./path_to_the_east_texture.xpm

F   0,     0,  255

C 255,255,255

11111111111111111111111111111111111111111111
10000000000000000000000000000000000010000001
1000000000000000000                 1      1
1                                   1      1111
1                                   1      0001
11111111111111111111111101111111111111111111111
11111111111111111111111111111111111111111111
