NO ./assets/textures/brick.xpm
SO ./assets/textures/stone.xpm
WE ./assets/textures/metal.xpm
EA ./assets/textures/wood.xpm

F   0,     0,  255

C 255,255,255

11111111111111111111111111111111111111111111
10000000000000000000000000000000000100000001
1000000000000000000          1    110      111
1     1              W            1         0000
1        1  1         	    1   111        111
11111111111111111111111111111111111111111111
11111111111111111111111001111111111111111111
