NO ./assets/textures/brick_hi.xpm
SO ./assets/textures/stone_hi.xpm
WE ./assets/textures/metal_hi.xpm
EA ./assets/textures/wood_hi.xpm

F   0,     0,  255

C 255,255,255

11111111111111111111111111111111111111111111
10000000000000000000000100000000000010000001
1000000000000000000      1         11      111
1                    W 0          11        0000
1                         1      110      111
11111111111111111111111111111111111111111111
11111111111111111111111001111111111111111111
