NO ./assets/textures/brick_hi.xpm
SO ./assets/textures/stone_hi.xpm
WE ./assets/textures/metal_hi.xpm
EA ./assets/textures/wood_hi.xpm

F 255,     155,  0
C 0, 255, 255


        11111111111111111111111111111111111111111111111
        10000000000000000000000000100000000000010000001
        1000000000000000000000000010000000011111      111
111111111000000000000000000E0000000000001111
10000000000000000000000000010000011111111
10000000000000000000000000000000011
11111110111111111111111111111111111111111111
11111101111111111111111001111111111111111111
11111111