NO ./assets/textures/brick_hi.xpm
SO ./assets/textures/stone_hi.xpm
WE ./assets/textures/metal_hi.xpm
EA ./assets/textures/wood_hi.xpm

F 23     0,  0
C 255,255,255


11111111111111111111111111111111111111111111
10000000000000000000000100000000000010000001
1000000000000000000000000010000000011      111
100000000000000000000E0000000000001
1000000000000000000000000001000001
1000000000000000000000000000000001
11111111111111111111111111111111111111111111
11111111111111111111111001111111111111111111